R 1050 520
NO ./textures/walls/Wall_05.xpm
SO ./textures/walls/Wall_12.xpm
WE ./textures/walls/Wall_08.xpm
EA ./textures/walls/Wall_02.xpm

C 51,185,200
F 0,53,100

111111111111111111111111111111
1E0000000000000000000000000001
111111111111111111111110111101
100000000000000000000000100101
101111111111110111111110100101
101000000000000000000010100101
101011111111111111111010000101
101111100000000000001011111111
100011111111101111101000000001
101000000000001000001110111101
101111111111101111110000000001
100010000000000000000111111101
111111111111111111111111111111