R 500 500
NO ./textures/wall.xpm
SO ./textures/wall.xpm
WE ./textures/wall.xpm
EA ./textures/wall.xpm

S ./textures/wall.xpm
C 200,200,200
F 30,30,30

11111
11111
1E001
10001
11111