R 720 720
NO ./textures/Wolf3D/GrasswallD.xpm
SO ./textures/Wolf3D/MultibrickD.xpm
WE ./textures/Wolf3D/SteelwallD.xpm
EA ./textures/Wolf3D/SteelwallswitchoffL.xpm

S ./textures/sprites/cage
D ./textures/Door.xpm
C 50,50,200
F 50,50,50

111111111111111111111111111111111111111111111111111111111111111111111111111111111
1DDDDDDDDDDDDDDDDDDDDDDDDDDDDDDDDDDDDDDDDDDDDDDDDDDDDDDDDDDDDDDDDDDDDDDDDDDDDDDD1
1DDDDDDDDDDDDDDDDDDDDDDDDDDDDDDDDDDDDDDDDDDDDDDDDDDDDDDDDDDDDDDDDDDDDDDDDDDDDDDD1
1DDDDDDDDDDDDDDDDDDDDDDDDDDDDDDDDDDDDDDDDDDDDDDDDDDDDDDDDDDDDDDDDDDDDDDDDDDDDDDD1
1DDDDDDDDDDDDDDDDDDDDDDDDDDDDDDDDDDDDDDDDDDDDDDDDDDDDDDDDDDDDDDDDDDDDDDDDDDDDDDD1
1DDDDDDDDDDDDDDDDD2DDDDDDDDDDDDDDDDDDDDDDDDDDDDDDDDDDDDDDDDDDDDDDDD2DDDDDDDDDDD01
100000000000000000000000000000000000000000000000000000000000000000000000000000001
100000000000000000000000000000000000000000000000000000000000000000000000000000001
100000000000000000000000000000000000000000000000000000000000000000000000000000001
100000000000000000000000000000000000000000000000000000000000000000000000000000001
100000000000000000000000000002000000000002000000000000000000000000000000000000001
100000000000000000000000000000000000000000000000000000000000000000000000000000001
100000000000000000000000000000000000000000000000000000000000000000000000000000001
100000000000000000000000000000000000000000000000000000000000000000000000000000001
1000000000000000000200000000000000000000N0000000000000000000000000000000000000001
100000000000000000000000000000000000000000000000000000000000000000000000000000001
100000000000000000000000000000000000000000000000000000000000000000000000000000001
100000000000000000000000000000000000000000000000000000000000000000010000000000001
1000000000000000000000000000000000000000000000000000000000000000000D0000000000001
100000000000000000000000000000000000000000000000000000000000000000010000000000001
1000000000000000000000000000000000000000000000000000000000000000000D0000000000001
100000000000000000000000000000000000000000000000000000000000000001D10000000000001
100000000000000000000000000000000000000000000000000000000000000000010000000000001
100000000000000000000000000002000000000000000000000000000000000000010000000000001
100000000000000000000000000000000000000000000000000000000000000000010000000000001
100000000000000000000000000000000000000000000000000000000000000000010000000000001
100000000000000000000000000000000000000000000000000000000000000000000000000000001
100000000000000000000000000000000000000000000000000000000000000000010000000000001
100000000000000000000000000000000000000000000000000000000000000000011000000000001
100000000000000000000000000000000000000000000000000000000000000000010000000000001
100000000000000000000000000000000000000000000000000000000000000000000000000000001
111111111111111111111111111111111111111111111111111111111111111111111111111111111
