R 720 720
NO ./textures/Wolf3D/GrasswallD.xpm
SO ./textures/Wolf3D/MultibrickD.xpm
WE ./textures/Wolf3D/SteelwallD.xpm
EA ./textures/Wolf3D/SteelwallswitchoffL.xpm

S ./textures/wall.xpm
C 50,50,200
F 50,50,50

111111111111111
120000000000001
100000000000201111111111
10000E000000000000000001
100000000000201111111101
120000000000001      101
111111111111101      101
        1111101111111101111111111
        1000000000110000000000001
        1011000001110000002000001
        1001000000000000000000001
111111111011000001110000000000001
100000000011000001110111110111111
11110111111111011100000010001
11110111111111011101010010001
11000000110101011100000010001
10002000000000001100000010001
10000000000000001101010010001
1100000111010101111101111000111
1111111111110101011111121000111111111111
120200000000000000000002220000000021   1
100000000000002000000000000000000011111
10200001001111111111111111111111111
10200001000111
10210001000011
10210001000001
11200000000011
11100000000111
1020000000111
10200000001111
10020000001 1 111  11 1111       1  1
 1110111121101110110010000111111101121111
1000000000000000000000000000000000000001
1111011111111000000100001111111111002111
10000000000000100000000010000000000111
1111111111111111100000111011112111110111
                100000000000000000000011
                110001111110011111011001
                11001     11000001000101
              111001       1000100010001
   1111111111110001     111 100001111111
   10000000000000111111110111100001
   10112111111001111000200011102001
   10000111112000000010000000001111
   11111   111111111111111111111111
