R 1050 520
NO ./textures/walls/Wall_10.xpm
SO ./textures/walls/Wall_11.xpm
WE ./textures/walls/Wall_01.xpm
EA ./textures/walls/Wall_07.xpm

S ./textures/sprites/female
D ./textures/doors/Door_02.xpm
C 50,50,200
F 50,50,50

111111111111111
100000000000001
100000000000001111111111
10000E00000000D000000021
100000000000001111111101
100000000000001      101
1111111111111D1      1D1
        1111101111111101111111111
        1000000000110000000000001
        1011000001110000000000001
        1001002000000000200000001
111111111D11000001110000000000001
10000000001100000111011111D111111
11110111111111011100000010001
11110111111111011101010010001
11000000110101011100000012001
10000000000000001100000010001
10000000000000001101010010001
1100000111010101111101111200111
1111111111110101011111101000111111111111
100000000200000000020000000000000001   1
100000000000000000000000000000000011111
11111D11D1111111111111111111111111
10000001000111
10010001000011
10010001000001
11000000000011
11100200000111
1000000000111
10000020001111
10000000001 1 111  11 1111       1  1
 11101111D1101110110010000111111101101111
1000000000000000020000000002000000000001
1111011111111000000100001111111111000111
10000000000000100000200010000000000111
1111111111111111100000111011110111110111
                100000000000000000000011
                110001111110011111011001
                11001     11000001000101
              1110D1       1000100010001
   1111111111110001     111 100001111111
   10000000020000111111110111102001
   10110111111201111000000011100001
   10000111110000000010000000001111
   11111   111111111111111111111111
