R 1050 520
NO ./textures/walls/Wall_05.xpm
SO ./textures/walls/Wall_12.xpm
WE ./textures/walls/Wall_08.xpm
EA ./textures/walls/Wall_02.xpm

S ./textures/sprites/male
D ./textures/doors/Door_03.xpm
C 51,185,200
F 0,53,100

111111111111111111111111111111
1E0000000000000000000000020001
11111111111111111111111D111101
1000000020000D0000000000100101
10111111111111D111111110100101
101000000000000200D00010120101
101011111111111111111010000101
101111100000000D00001011111111
120011111111101111101000020001
101000000D00001000001110111101
101111111111101111110000D00001
100010000D00000000200111111101
111111111111111111111111111111