R 1050 520
NO ./textures/walls/Wall_10.xpm
SO ./textures/walls/Wall_11.xpm
WE ./textures/walls/Wall_01.xpm
EA ./textures/walls/Wall_07.xpm

S ./textures/sprites/female
D ./textures/doors/Door_02.xpm
C 50,50,200
F 50,50,50

111111111111111111111111111111111111111111
122222222222222222222222222222222222222221
122222222222222222222222222222222222222221
122222222222222222222222222222222222222221
122222222222222222222222222222222222222221
122222222222222222222222222222222222222221
122222222222222222222222222222222222222221
122222222222222222222222222222222222222221
122222222222222222222222222222222222222221
122222222222222222222222222222222222222221
122222222222222222222222222222222222222221
122222222222222222222222222222222222222221
122222E22222222222222222222222222222222221
122222222222222222222222222222222222222221
122222222222222222222222222222222222222221
122222222222222222222222222222222222222221
122222222222222222222222222222222222222221
122222222222222222222222222222222222222221
122222222222222222222222222222222222222221
122222222222222222222222222222222222222221
122222222222222222222222222222222222222221
122222222222222222222222222222222222222221
122222222222222222222222222222222222222221
122222222222222222222222222222222222222221
122222222222222222222222222222222222222221
122222222222222222222222222222222222222221
111111111111111111111111111111111111111111
